111111111
1000001E1
100000001
10P011101
10001C101
111111111
