111111111
1000001E1
100000101
10P011101
10001C101
111111111
