11111111111111111111111111111111111
10000000000000000000000000000E00001
100000C0000000000000000000000000001
10000000000000000000000000000000001
10000000000000000000000000000000001
10000000000000000000000000000000001
10000000000000000000000000000000001
10000000000000000000000000000000001
10000000000000000000000000000000001
10000000C000000000000000000000000C1
100000000000000000000000000000000P1
11111111111111111111111111111111111